########################################################################################
##....................................................................................##
##....................................................................................##
##....############################################################################....##
##....################################..............##############################....##
##....####..........................##..............##..........................##....##
##....####..........................##..............##..........................##....##
##....####..........................##..............##..........................##....##
##....####..........................##..............##..........................##....##
##....####..........................##..............##..........................##....##
##....####..................##..............................######..............##....##
##....####..................####....##..............##..........................##....##
##....####..........................##..............##..........................##....##
##....####..........................##..............##..........................##....##
##....####..........................##..............##..........................##....##
##....####..........................##..............##..........................##....##
##....####..........................##..............##..............##..........##....##
##....####..........................##..............##..........................##....##
##....########..............##########..............########################..####....##
##....##........................................................................##....##
##....##........................................................................##....##
##....##........................................................................##....##
##....##........................................................................##....##
##....##........................................................................##....##
##....##........................................................................##....##
##....##........................................................................##....##
##....########..............##########..........................................##....##
##....####..........................##..........................................##....##
##....####..........................##..........................................##....##
##....####..........................##..........................................##....##
##....####......####............................................................##....##
##....####......##..............................................................##....##
##....####......................................................................##....##
##..............................................................................##....##
##..............................................................................##....##
##....................................................................................##
##....................................................................................##
##..................................##................................................##
##..................................##................................................##
##..................................##..........................................##....##
##....############################################################################....##
##....................................................................................##
##....................................................................................##
########################################################################################
